00000000000000000000444444444444400000000000000000000000
00000000000000000044444444444444444444000000000000000000
00000000000000000444444444444444444444440000000000000000
00000000000000044444444444444444444444444000000000000000
00000000000004444444444444444444444444444400000000000000
00000000000044444444444444444444444444444440000000000000
00000000000444444444444444444444444444444444000000000000
00000000044444444444444444444444444444444444400000000000
00000000444444444444444444444444444444444444440000000000
00000004444444444444446664446664444444444444444000000000
00000044444444444444466166466166666644444444444400000000
00000444444444444446661116661111661664444444444440000000
00004444444444444666111111111111111166444444444444000000
00044444444444446611111111111111111116444444444444400000
00044444444444466111111111111111111116444444444444440000
00444444444446661111111111111111111116644444444444444000
00444444444466111111111111111111111111666644444444444000
04444444444661111111111111111111111111111664444444444400
04444444444611111111111111111111111111111166444444444400
44444444444611111111111111111111111111111116644444444440
44444444446611111111111111111111111111111111644444444440
44444444466111111111111111111111111111111111664444444440
44444444461111111111111111111111111111111111164444444440
44444444461111111111111111111111111111111111164444444444
44444444461111111111111111111111111111111111164444444444
44444444461111111111111111111111111111111111166444444444
44444444461111111111111111111111111111111111116444444444
44444444466111111111111111111111111111111111116444444444
44444444446111111111111111111111111111111111116444444444
44444444446111111111111111111111111111111111116444444444
44444444446611111111111111111111111111111111166444444444
44444444446611111111111111111111111111111111664444444444
44444444466111111111111111111111111111111116644444444444
44444444461111111111111111111111111111111111664444444440
44444444461111111111111111111111111111111111164444444440
44444444461111111111111111111111111111111111164444444440
44444444461111111111111111111111111111111111164444444440
44444444466111111111111111111111111111111111664444444440
44444444446111111111111111111111111111111111644444444440
44444444446611111111111111111111111111111116644444444440
04444444444661111111111111111111111111111166444444444400
04444444444466111111111111111111111111166664444444444400
00444444444446611111111111111111111111664444444444444000
00444444444444661111111111111111111111644444444444444000
00044444444444466111111111111111111111644444444444440000
00004444444444446611111111111111111116644444444444400000
00000444444444444666111111111111111666444444444444000000
00000044444444444446666111111111666644444444444440000000
00000004444444444444446666611166644444444444444400000000
00000000444444444444444444661664444444444444444000000000
00000000044444444444444444466644444444444444440000000000
00000000004444444444444444444444444444444444400000000000
00000000000444444444444444444444444444444444000000000000
00000000000044444444444444444444444444444440000000000000
00000000000004444444444444444444444444444400000000000000
00000000000000044444444444444444444444440000000000000000
00000000000000000444444444444444444444000000000000000000
00000000000000000000444444444444444000000000000000000000
00000000000000000000000444444444440000000000000000000000
00000000000000000000000004444444000000000000000000000000
