00000000004444444444444444000000000
00000000044444444444444444400000000
00000000444444444444444444440000000
00000044444666644666646664444000000
00000444444611666611666166444400000
00004444446611166111111116644400000
00044446666111111111111111644440000
00044466111111111111111111664444000
00044461111111111111111111164444400
00444461111111111111111111166644400
04444661111111111111111111111644440
44446611111111111111111111111644444
44466111111111111111111111111666444
44461111111111111111111111111116444
44461111111111111111111111111116444
44461111111111111111111111111116444
44466111111111111111111111111116444
44446111111111111111111111111116444
44446611111111111111111111111116444
44466111111111111111111111111116444
44461111111111111111111111111116444
44461111111111111111111111111166444
44461111111111111111111111111664444
44461111111111111111111111111164440
44466111111111111111111111111664440
44446661111111111111111111111644440
04444466111111111111111111116644400
00444446111111111111111111166444400
00044446611111111111111111664444000
00004444661111111111111116644440000
00000444466111116661111166444400000
00000044446666666466666664444000000
00000004444444444444444444440000000
00000000444444444444444444400000000
00000000044444444444444444000000000
