000000000000000000000044444444444444444444444440000000000000000000000
000000000000000000004444444444444444444444444444400000000000000000000
000000000000000000444444444444444444444444444444444000000000000000000
000000000000000044444444444444444444444444444444444440000000000000000
000000000000000444444444444444444444444444444444444444000000000000000
000000000000004444444444444444444444444444444444444444400000000000000
000000000000044444444444444444444444444444444444444444440000000000000
000000000000444444444444444444444444444444444444444444444000000000000
000000000004444444444444444444444444444444444444444444444400000000000
000000000044444444444444444444444444444444444444444444444440000000000
000000000444444444444444444444444444444444444444444444444444000000000
000000004444444444444444666666666666666666666444444444444444400000000
000000044444444444444466611111111111111111116664444444444444440000000
000000444444444444444661111111111111111111111166444444444444444000000
000004444444444444446611111111111111111111111116644444444444444400000
000044444444444444466111111111111111111111111111664444444444444440000
000444444444444444661111111111111111111111111111166444444444444444000
000444444444444446611111111111111111111111111111116644444444444444000
004444444444444466111111111111111111111111111111111664444444444444400
004444444444444661111111111111111111111111111111111166444444444444400
044444444444446611111111111111111111111111111111111116644444444444440
044444444444466111111111111111111111111111111111111111664444444444440
444444444444661111111111111111111111111111111111111111166444444444444
444444444444611111111111111111111111111111111111111111116444444444444
444444444446611111111111111111111111111111111111111111116644444444444
444444444446111111111111111111111111111111111111111111111644444444444
444444444446111111111111111111111111111111111111111111111644444444444
444444444446111111111111111111111111111111111111111111111644444444444
444444444446111111111111111111111111111111111111111111111644444444444
444444444446111111111111111111111111111111111111111111111644444444444
444444444446111111111111111111111111111111111111111111111644444444444
444444444446111111111111111111111111111111111111111111111644444444444
444444444446111111111111111111111111111111111111111111111644444444444
444444444446111111111111111111111111111111111111111111111644444444444
444444444446111111111111111111111111111111111111111111111644444444444
444444444446111111111111111111111111111111111111111111111644444444444
444444444446111111111111111111111111111111111111111111111644444444444
444444444446111111111111111111111111111111111111111111111644444444444
444444444446111111111111111111111111111111111111111111111644444444444
444444444446111111111111111111111111111111111111111111111644444444444
444444444446111111111111111111111111111111111111111111111644444444444
444444444446111111111111111111111111111111111111111111111644444444444
444444444446111111111111111111111111111111111111111111111644444444444
444444444446111111111111111111111111111111111111111111111644444444444
444444444446611111111111111111111111111111111111111111116644444444444
444444444444611111111111111111111111111111111111111111116444444444444
444444444444661111111111111111111111111111111111111111166444444444444
044444444444466111111111111111111111111111111111111111664444444444440
044444444444446611111111111111111111111111111111111116644444444444440
004444444444444661111111111111111111111111111111111166444444444444400
004444444444444466111111111111111111111111111111111664444444444444400
000444444444444446611111111111111111111111111111116644444444444444000
000444444444444444661111111111111111111111111111166444444444444444000
000044444444444444466111111111111111111111111111664444444444444440000
000004444444444444446611111111111111111111111116644444444444444400000
000000444444444444444661111111111111111111111166444444444444444000000
000000044444444444444466611111111111111111116664444444444444440000000
000000004444444444444444666666666666666666666444444444444444400000000
000000000444444444444444444444444444444444444444444444444444000000000
000000000044444444444444444444444444444444444444444444444440000000000
000000000004444444444444444444444444444444444444444444444400000000000
000000000000444444444444444444444444444444444444444444444000000000000
000000000000044444444444444444444444444444444444444444440000000000000
000000000000004444444444444444444444444444444444444444400000000000000
000000000000000444444444444444444444444444444444444444000000000000000
000000000000000044444444444444444444444444444444444440000000000000000
000000000000000000444444444444444444444444444444444000000000000000000
000000000000000000004444444444444444444444444444400000000000000000000
000000000000000000000044444444444444444444444440000000000000000000000
