0000044444444400000
0000444444444440000
0004444444444444000
0044446666666444400
0444466111116644440
4444661111111664444
4446611111111166444
4446111111111116444
4446111111111116444
4446111111111116444
4446111111111116444
4446111111111116444
4446611111111166444
4444661111111664444
0444466111116644440
0044446666666444400
0004444444444444000
0000444444444440000
0000044444444400000
