000000004444440000000000000
000000044444444444444000000
000004444444444444444400000
000044444666644444444440000
000444446611664466664444000
000444666111166661166444000
004444611111111111116444400
044446611111111111116444440
444466111111111111116644444
444661111111111111111666444
444611111111111111111116444
444611111111111111111116444
444611111111111111111166444
444661111111111111111664444
444466111111111111111166444
444661111111111111111116444
444611111111111111111116444
444666111111111111111116444
444446611111111111111166444
044444611111111111111664444
004444611111111111116644440
000444661116611111666444400
000444466166661166644444000
000044446664466664444440000
000004444444444444444400000
000000444444444444440000000
000000044444444444000000000
