aaaaa000000aaaa
aaaa00000000aaa
aaa0022222000aa
aa002111112000a
a00211111112000
002111111111200
002111111111200
002111111111200
002111111111200
002111111111200
00021111111200a
0000211111200aa
a00002222200aaa
aa000000000aaaa
aaa0000000aaaaa
